start:stage.Pos:0,1

____________________
IIIIIIIIIIIIIIIIIII#
iiii.i##i..i..i..i.#
I_@.________.......#
...................#
...................#
