start:stage.Pos:0,1

_..................#
#...##.............#
_....___...........#
._@.._##____.......#
..#__#____.#.......#
...................#
