start:stage.Pos:0,1

_#_#_#_#_#_#_#_#_#_#
__________.........#
....######.........#
__@.######__.......#
__________.#.......#
...................#
