start:stage.Pos:0,1

_#_#_#_#_#_#_#_#_#_#
_____I____i........#
....######.........#
_I@.######__.......#
__________.#.......#
...................#
