start:stage.Pos:0,1

____________________
IIIIIIIIIIIIIIIIIII#
_iii.i##i..i..i..i.#
I_@.________.......#
...................#
...................#
