start:stage.Pos:0,1

_#_#_#_#_#_#_#_#_#_#
_._._._..#.........#
__..__..__..__..__.#
___......###.......#
____.....####......#
####################
