obj:value
obj2:value2,value3,

_..................#
#...##.............#
__@_____...........#
.._.._##____.......#
..#__#____.#.......#
...................#
