obj:value
obj2:value2,value3,

_..................#
#_.................#
._....__...........#
.#_.._##____.......#
..#__#____.#.......#
...................#
